------------------------------------------------------------
-                                                          -
- - ------- ----------- - -- -- -- - ----------- ------- - -
- -                     - -- -- -- -                     - -
- - ---- ----------- ---- -- -- -- ---- ----------- ---- - -
- -                  ---- --    -- ----                  - -
- --- --------- --------- --gggg-- --------- --------- --- -
- -                          --                          - -
- - -------------- --------- -- --------- -------------- - -
- - -                      - -- -                      - - -
- - - ------- -------- --- - -- - --- -------- ------- - - -
- - -         -              --              -         - - -
- - ---------------------------------------------------- - -
-p                                                         -
------------------------------------------------------------
